border_size=1
usage=map

Gs^Fp       , Gs^Fp       , Gs          , Gs          , Gs          , Ds          , Ds          , Ds          , Ds          , Ss          , Ss          , Ww          , Ww          , Ds          , Ds          , Ss          , Ss          , Ss          , Ds          , Ds          , Ds          , Gs          , Gs          , Ds          , Ds          , Ss          , Ss          , Ss          , Ds          , Gs          , Gs          , Ss          , Ss          , Ds          , Ds          , Ds          
Gs^Fp       , Gs^Fp       , Gs^Vht      , Gs          , Gs          , Ds          , Ds          , Ds          , Ds          , Ss          , Ss          , Ww          , Ww          , Ds          , Ds          , Ss          , Ss          , Ss          , Ds          , Ds          , Ds          , Gs          , Gs          , Ds          , Ds          , Ss          , Ss          , Ss          , Ce          , Ce          , Ce          , Ss          , Ss          , Ds          , Ds          , Ds          
Ds          , Ds          , Ds          , Gs          , Gs          , Ds          , Gs          , Ds          , Gs          , Gs          , Gs          , Ww          , Ss^Vhs      , Ss          , Ds          , Ss          , Ss          , Ss          , Ds          , Ds          , Gs          , Gs^Vht      , Gs          , Ds          , Ss          , Ss          , Ss          , Ds          , Ce          , Gs          , Ce          , Ds          , Ds          , Ss          , Ss          , Ss          
Ds          , Ds          , Chr         , Ds          , Gg          , Ds          , Gs          , Gs          , Gs          , Gs          , Gs          , Ww          , Gs          , Gs          , Ds          , Ds          , Ss          , Ds          , Ds          , Ds          , Gs          , Gs          , Gs          , Ss          , Ss          , Ds          , Ds          , Ce          , Gg          , Ce          , Gg          , Ce          , Ds          , Ss          , Ss          , Ss          
Ds          , Chr         , Ss^Vhs      , Chr         , 2 Khr       , Gg          , Re          , Ss^Vhs      , Gs          , Gs          , Ww          , Ww          , Ds          , Ds          , Ds          , Gs          , Ds          , Gs          , Gs          , Ss          , Ss          , Gs          , Ds          , Gs          , Ss          , Ss          , Ds          , Ce          , Ce          , Ce          , 1 Ke        , Ce          , Ss          , Ss          , Ss          , Ss          
Ds          , Chr         , Chr         , Chr         , Ss          , Chr         , Ss          , Ss          , Ww          , Ww          , Ds          , Ds          , Ds          , Ds          , Ss          , Gs          , Ss          , Ss          , Ds          , Ds          , Ds          , Ds          , Ss          , Ds          , Ds          , Ww^Bw/      , Ds          , Gg          , Ce          , Gs^Vht      , Ce          , Ds          , Ss          , Ds          , Ss          , Ss          
Ds          , Ds          , Ds          , Chr         , Chr         , Chr         , Gs          , Ss          , Ww          , Ww          , Gs          , Gs^Vht      , Gs          , Gs          , Ds          , Ds          , Ss          , Ds          , Gs          , Gs          , Ss          , Ss          , Ss          , Ss          , Ss          , Ss          , Ds          , Gg          , Gg          , Ce          , Gg          , Gs          , Gs          , Ss          , Ds          , Ds          
Gs          , Gs          , Gs          , Gs^Vht      , Gs          , Gs          , Gs          , Ss          , Ss          , Ww          , Ww          , Gs          , Gs          , Gs          , Gs          , Gs          , Gs          , Ss          , Gs          , Gs          , Gs          , Ds          , Ss          , Ss          , Ss          , Ds          , Ds          , Gs          , Ww          , Gg          , Gs          , Gs          , Gs          , Ss          , Ds          , Ds          
Ds          , Ds          , Ds          , Ds          , Gs^Vht      , Ds          , Ds          , Gs          , Ss          , Ss          , Ww          , Gs          , Gs          , Ss          , Ss          , Ss          , Gs          , Gs          , Ds          , Ds          , Ds          , Gs          , Gs          , Ss          , Ss          , Gs          , Gs          , Gs          , Gs          , Gs          , Ds          , Gs          , Ss          , Ss          , Ss          , Ss          
Ds          , Ds          , Ds          , Ds          , Rd          , Ds          , Ds          , Gs          , Ww          , Ww          , Gs          , Ss          , Ss          , Ss          , Gs          , Gs          , Gs          , Gs          , Ds          , Ds          , Ds          , Gs          , Gs          , Gs          , Ss          , Ss          , Ss          , Ds          , Gs          , Gs          , Ds          , Ss          , Ss          , Ss          , Gs          , Gs          
Ds          , Ds          , Ds          , Ds          , Ds          , Rd          , Ww^Bw\      , Ww          , Ww          , Ss          , Ss^Vhs      , Ds          , Ss          , Ds          , Gs          , Ds          , Ds          , Ds          , Ds          , Gs          , Gs          , Gs^Fp       , Gs          , Ds          , Ss          , Ds          , Ds          , Ds          , Gs^Vht      , Ds          , Ds          , Ds          , Ds          , Gs          , Gs          , Gs          
Gs          , Gs          , Gs          , Ds          , Ss^Vhs      , Ww          , Gs          , Rd          , Gs          , Ss          , Ss          , Ss          , Ds          , Ds          , Ds          , Ds          , Ds          , Gs          , Gs          , Gs          , Ss^Vhs      , Gs          , Gs          , Ds          , Ss          , Ds          , Ds          , Ds          , Ds          , Ds          , Ds          , Ds          , Ds          , Gs          , Gs          , Gs          
Gs          , Gs          , Gs          , Ds          , Ww          , Gs          , Gs          , Rd          , Gs^Vht      , Gs          , Ss          , Ds          , Ds          , Ds          , Ss          , Ss          , Ss          , Ss          , Ss          , Ss          , Ds          , Ds          , Gs          , Gs          , Gs          , Ss          , Ss          , Ss          , Gs          , Ss          , Gs          , Gs          , Gs          , Gs          , Gs          , Gs          
Gs          , Gs          , Wwf         , Ww          , Ds          , Ds          , Gs          , Rd          , Rd          , Gs          , Ss          , Ss          , Ds          , Ds          , Ds          , Gs          , Ss          , Ss          , Ss          , Ss          , Ds          , Ds          , Ds          , Gs          , Ss          , Ss          , Ss          , Ss          , Ss          , Ss          , Gs          , Gs          , Ss^Vhs      , Gs          , Gs          , Gs          
Ww          , Ww          , Ds          , Ds          , Ds          , Ds          , Ds          , Ds          , Ds          , Ss          , Ss          , Ss          , Ss          , Gs          , Gs          , Gs          , Gs          , Gs          , Gs          , Ss          , Ss          , Ds          , Ds          , Ds          , Ds          , Gs          , Ss          , Ds          , Ds          , Ds          , Ds          , Ds          , Gs          , Gs          , Gs          , Gs          
Gs          , Gs          , Gs          , Ds          , Ds          , Ds          , Ds          , Ds          , Ss          , Ss          , Ss          , Ww^Bw\      , Rd          , Gs          , Gs          , Ss^Vhs      , Gs          , Ds          , Ds          , Ds          , Ds          , Ss          , Ds          , Ds          , Ds          , Gs          , Ds          , Ds          , Ds          , Ds          , Ds          , Ds          , Ds          , Ss          , Gs          , Gs          
Gs          , Gs          , Gs          , Gs          , Ds          , Ds          , Ds          , Ds          , Ss          , Ss          , Ss          , Ss          , Gs          , Rd          , Gs          , Rd          , Gs          , Gs          , Ds          , Ds          , Ds          , Ss          , Ss          , Ss^Vhs      , Rr          , Gs          , Ds          , Ds          , Chs         , Ss          , Ss          , Ss          , Ss          , Ss          , Ss          , Ss          
Gs          , Gs          , Gs          , Gs          , Ss          , Ds          , Ds          , Ds          , Ds          , Ss          , Ds          , Ds          , Ds          , Ds          , Rd          , Rd          , Gs          , Gs          , Gs          , Gs          , Gs          , Gs          , Ss          , Ss          , Ss          , Rr          , Rr          , Chs         , 3 Khs       , Chs         , Ss          , Ss          , Ss          , Ss          , Ss          , Ss          
Ss          , Ss          , Ss          , Ss          , Ss          , Ds          , Gs          , Ds          , Gs          , Gs          , Gs          , Ds          , Chr         , 5 Khr       , Chr         , Ds          , Ds          , Ds          , Gs          , Gs          , Gs          , Gs          , Gs          , Gs          , Ss          , Ss          , Ss          , Ss          , Chr         , Chr         , Ds          , Ss          , Ss          , Ss          , Ss          , Ss          
Ss          , Ss          , Ss          , Ss          , Ss          , Gs          , Gs          , Gs          , Gs          , Ds          , Ds          , Chr         , Ds          , Chr         , Ds          , Chr         , Ss          , Ss          , Gs          , Ds          , Gs          , Ds          , Ds          , Ds          , Ss          , Ss          , Ss          , Ss          , Chr         , Ds          , Ds          , Ds          , Ss          , Gs          , Ss          , Ss          
Gs          , Gs          , Gs          , Ss          , Ss          , Ss          , Gs          , Gs^Fp       , Gs          , Ss^Vhs      , Gs          , Ds          , Ds          , Chr         , Ds          , Ds          , Ss          , Ss          , Ss          , Ss          , Ds          , Ds          , Ds          , Ds          , Ss          , Ss          , Gs          , Gs          , Ds          , Ds          , Ds          , Ds          , Gs          , Gs          , Gs          , Gs          
Gs          , Gs          , Gs          , Gs          , Ds          , Ds          , Ds          , Gs          , Gs          , Gs          , Gs          , Ds          , Ds          , Chr         , Ds          , Ss          , Ss          , Ss          , Ss          , Ds          , Ds          , Ds          , Ds          , Ds          , Ss          , Ss          , Ss          , Gs          , Gs          , Gs          , Ds          , Gs          , Gs^Fp       , Gs^Vht      , Gs          , Gs          
Gs          , Gs          , Gs          , Gs          , Ds          , Ds          , Ds          , Gs          , Ss          , Gs          , Ss          , Rr          , Ds          , Chr         , Ds          , Ds          , Gs          , Gs          , Gs          , Ds          , Ds          , Ds          , Ds          , Ds          , Ss          , Ss^Vhs      , Gs          , Ss          , Ss          , Gs          , Gs          , Gs          , Gs          , Gs          , Gs          , Gs          
Gs          , Gs          , Gs          , Ds          , Ds          , Ds          , Ss          , Ss          , Ss          , Ss          , Gs          , Rr          , Gs          , Gs          , Gs          , Gs^Vht      , Gs          , Gs          , Ds          , Ds          , Ds          , Ds          , Gs          , Gs          , Gs          , Ss          , Ss          , Ss          , Gs          , Ss          , Gs          , Ds          , Ds          , Ds          , Gs          , Gs          
Ss          , Ss          , Ss          , Gs          , Gs          , Gs          , Ss          , Ds          , Ds          , Gs          , Rr          , Rr          , Gs          , Ds          , Ds          , Ds          , Ss          , Ss          , Ss          , Ds          , Ds          , Ds          , Ds          , Ds          , Ds          , Ss          , Ss          , Ss          , Ds          , Ds          , Ds          , Ds          , Ds          , Ds          , Ds          , Ds          
Ss          , Ss          , Ss          , Ss          , Ss          , Ss          , Ss          , Gs          , Gs          , Rr          , Gs          , Gs          , Gs          , Ds          , Ds          , Ds          , Ds          , Gs          , Gs          , Ds          , Ds          , Ds          , Ds          , Ds          , Ds          , Ds          , Rd          , Rd          , Gs          , Gs^Vht      , Gs          , Gs          , Ds          , Gs          , Gs          , Gs          
Gs          , Gs          , Gs          , Gs          , Ss          , Ss          , Ss          , Ss          , Gs          , Rr          , Gs          , Gs          , Ds          , Ds          , Ds          , Ds          , Ds          , Ds          , Gs          , Gs          , Gs^Vht      , Gs          , Gs          , Ds          , Ds          , Ds          , Chr         , Rd          , Rd          , Chr         , Rd          , Gs          , Chr         , Ss          , Ss          , Ss          
Gs          , Gs          , Ds          , Ds          , Ds          , Ds          , Ds          , Ds          , Chr         , Chr         , Chr         , Gs          , Ss          , Gs          , Gs          , Gs          , Ds          , Ds          , Ds          , Ds          , Ds          , Gs          , Gs          , Rd          , Rd          , Rd          , Ds          , Chr         , Chr         , Chr         , Chr         , Chr         , Ds          , Rd          , Ss          , Ss          
Gs          , Gs          , Gs          , Ds          , Ds          , Ds          , Ds          , Chr         , Ds          , Ds          , Ds          , Chr         , Gs          , Ss          , Ss          , Ss          , Ds          , Ds          , Ds          , Ds          , Ds          , Gs          , Ss          , Ss          , Rd          , Ss          , Ds          , Rd          , Chr         , 6 Khr       , Chr         , Rd          , Ds          , Rd          , Gs          , Gs          
Gs          , Gs          , Gs          , Gs          , Ds          , Ds          , Gg          , 4 Khr       , Gg          , Ds          , Ds          , Chr         , Ss          , Ss          , Ss          , Ss          , Ds          , Ds          , Ds          , Ds          , Ds          , Ds          , Ds          , Ss          , Ss          , Ss          , Chr         , Chr         , Rd          , Chr         , Rd          , Chr         , Chr         , Gs          , Gs          , Gs          
Gs          , Gs          , Gs          , Gs          , Ss          , Ss          , Ss          , Chr         , Chr         , Gg          , Chr         , Chr         , Gs          , Gs          , Ss          , Ss          , Ss          , Ds          , Ds          , Ds          , Ds          , Ds          , Ds          , Ds          , Ss          , Ss          , Ss          , Rd          , Rd          , Chr         , Rd          , Rd          , Ds          , Ds          , Ds          , Ds          
Ss          , Ss          , Ss          , Ss          , Ss          , Gs          , Ds          , Rr          , Rr          , Chr         , Gs          , Ds          , Gs          , Gs          , Gs          , Gs          , Ss          , Ds          , Ds          , Ss^Vhs      , Ds          , Ds          , Gs          , Gs          , Gs          , Gs          , Ds          , Rd          , Gs          , Gs^Vht      , Gs          , Gs          , Ds          , Gs          , Gs          , Gs          
Ss          , Ss          , Ss          , Ss          , Ss          , Ss          , Gs          , Gs          , Rr          , Gs          , Ds          , Ds          , Ds          , Ds          , Gs          , Gs          , Gs          , Ss          , Ss          , Ds          , Ss          , Gs          , Ss          , Gs          , Ds          , Ds          , Ds          , Ds          , Ds          , Gs          , Gs          , Gs          , Ss          , Ss          , Gs          , Gs          
Gs          , Gs          , Gs          , Gs          , Gs          , Gs          , Ds          , Ds          , Ds          , Rr          , Rr          , Ds          , Ds          , Ds          , Ds          , Gs          , Ss          , Ss          , Ss          , Ss          , Ss          , Ss          , Ss          , Gs          , Ds          , Ds          , Ds          , Ds          , Ds          , Ds          , Ss          , Ss          , Ss          , Gs          , Gs          , Gs          
Gs          , Gs          , Gs          , Gs          , Gs          , Gs          , Ds          , Ds          , Ds          , Rr          , Rr          , Ds          , Ds          , Ds          , Ds          , Gs          , Ss          , Ss          , Ss          , Ss          , Ss          , Ss          , Ss          , Gs          , Ds          , Ds          , Ds          , Ds          , Ds          , Ds          , Ss          , Ss          , Ss          , Gs          , Gs          , Gs          
