border_size=1
usage=map

Rp          , Rp          , Rp          , Gs^Fms      , Gs^Fms      , Gs^Fms      , Gs^Fms      , Gs^Fms      , Gs^Fms      , Gs^Fms      , Gs^Fms      , Gs^Fp       , Gs^Fp       , Gs^Fp       , Gs^Fp       , Gs^Fp       , Gs^Fp       , Gs^Fp       , Gs^Fp       , Ww          , Ggf         , Gg          , Ggf         , Gs^Fp       , Gs^Fp       , Gs^Fp       , Gs^Fp       , Gs^Fp       , Gs^Fp       , Gs^Fp       , Ggf         , Ggf         , Ggf         , Rp          , Ggf         , Ggf         , Ggf         , Gs^Fp       , Gs^Fp       , Gs^Fp       , Gs^Fp       , Gs^Fp       
Rp          , Rp          , Rp          , Gs^Fms      , Rp          , Gs^Fms      , Gs^Fms      , Gs^Fms      , Gs^Fp       , Gs^Fp       , Gs^Fms      , Gs^Fp       , Gs^Fp       , Gs^Fp       , Ggf         , Ggf         , Gs^Fp       , Gs^Fp       , Gs^Fp       , Ww          , Ggf         , Ggf         , Ggf         , Gs^Fp       , Gs^Fp       , Ggf         , Gs^Fp       , Gs^Fp       , Gs^Fp       , Gs^Fp       , Ggf         , Ggf         , Ggf         , Rp          , Gg^Ve       , Ggf         , Ggf         , Gs^Fp       , Gs^Fp       , Gs^Fp       , Gs^Fp       , Gs^Fp       
Gs^Fms      , Gs^Fms      , Gs^Fms      , Rp          , Gs^Fms      , Rp          , Gs^Fms      , Gs^Fds      , Gs^Fds      , Gs^Fds      , Gs^Fds      , Gs^Fms      , Gs^Fms      , Gs^Fp       , Ggf         , Gs^Fp       , Gg^Ve       , Gs^Fp       , Ww          , Ww          , Gs^Fp       , Ggf         , Gs^Fp       , Gs^Fp       , Gs^Fp       , Ggf         , Ggf         , Ggf         , Ggf         , Ggf         , Gs^Fp       , Ggf         , Ggf         , Rp          , Ggf         , Gs^Fp       , Ggf         , Gg^Ve       , Ggf         , Gs^Fp       , Gs^Fp       , Gs^Fp       
Gs^Fms      , Gs^Fms      , Gs^Fms      , Gs^Fms      , Gs^Fms      , Rp          , Rp          , Gs^Fds      , Cv          , Cv          , Ggf         , Gg^Ve       , Ggf         , Gs^Fp       , Gs^Fp       , Gs^Fp       , Gs^Fp       , Wo          , Ww          , Gs^Fp       , Gs^Fp       , Gs^Fp       , Ggf         , Gs^Fp       , Ggf         , Ggf         , Ggf         , Ggf         , Gg^Ve       , Ggf         , Ggf         , Gs^Fp       , Ggf         , Rp          , Gs^Fp       , Gs^Fp       , Ggf         , Ggf         , Ggf         , Gs^Fp       , Gs^Fp       , Gs^Fp       
Ggf         , Ggf         , Gs^Fms      , Gs^Fms      , Gs^Fds      , Gs^Fms      , Cv          , Kv          , Rp          , Ggf         , Gg^Ve       , Ggf         , Ggf         , Ggf         , Gs^Fp       , Gs^Fp       , Gs^Fp       , Wo          , Ww          , Gs^Fp       , Ggf         , Gs^Fp       , Gs^Fp       , Ggf         , Ggf         , Ggf         , Gs^Fp       , Ggf         , Ggf         , Ggf         , Ggf         , Ggf         , Gs^Fp       , Rp          , Ggf         , Gs^Fp       , Ggf         , Ggf         , Ggf         , Ggf         , Gs^Fp       , Gs^Fp       
Ggf         , Ggf         , Gs^Fms      , Gs^Fp       , Gs^Fds      , Cv          , Gg^Ve       , Ggf         , Ggf         , Rp          , Rp          , Ggf         , Ggf         , Gg^Ve       , Cv          , Gs^Fp       , Gs^Fp       , Ww          , Gs^Fp       , Gs^Fp       , Gg^Ve       , Gs^Fp       , Gs^Fp       , Ggf         , Ggf         , Ggf         , Gs^Fp       , Ggf         , Ggf         , Ggf         , Ggf         , Ggf         , Rp          , Rp          , Ggf         , Ggf         , Ggf         , Gs^Fp       , Gs^Fp       , Gs^Fp       , Gs^Fp       , Gs^Fp       
Ggf         , Ggf         , Ggf         , Ggf         , Ggf         , Ggf         , Ggf         , Ggf         , Ggf         , Ggf         , Gs^Fp       , Rp          , Kv          , Cv          , Ggf         , Ggf         , Ww          , Ww          , Gg^Ve       , Ggf         , Ggf         , Ggf         , Ggf         , Gs^Fp       , Gs^Fp       , Gs^Fp       , Ggf         , Ggf         , Gs^Fp       , Gg^Ve       , Gs^Fp       , Gs^Fp       , Cv          , Ggf         , Ggf         , Gs^Fp       , Ggf         , Gs^Fp       , Ggf         , Gs^Fp       , Gs^Fp       , Gs^Fp       
Gs^Fms      , Gs^Fms      , Ggf         , Ggf         , Ggf         , Gs^Fp       , Gg^Ve       , Gs^Fp       , Ggf         , Gs^Fp       , Cv          , Cv          , Ggf         , Rp          , Ww^Bw\      , Ww          , Ww          , Gs^Fp       , Gs^Fp       , Ggf         , Ggf         , Ggf         , Ggf         , Gs^Fp       , Ggf         , Ggf         , Gs^Fp       , Ggf         , Gs^Fp       , Gs^Fp       , Cv          , Cv          , 1 Kv        , Cv          , Cv          , Ggf         , Gs^Fp       , Ggf         , Ggf         , Gg^Ve       , Gs^Fp       , Gs^Fp       
Gs^Fms      , Gs^Fms      , Gs^Fp       , Gs^Fp       , Ggf         , Gs^Fp       , Gs^Fp       , Gg^Ve       , Gs^Fp       , Gs^Fp       , Ww          , Ww          , Ww^Bw|      , Ww          , Gs^Fp       , Rp          , Rp          , Ww          , Ww          , Gs^Fp       , Ggf         , Gs^Fp       , Gs^Fp       , Ggf         , Ggf         , Gs^Fp       , Ggf         , Gs^Fp       , Ggf         , Gs^Fp       , Gs^Fp       , Cv          , Rp          , Cv          , Ggf         , Ggf         , Ggf         , Ggf         , Gs^Fp       , Gs^Fp       , Gs^Fp       , Gs^Fp       
Gs^Fp       , Gs^Fp       , Gs^Fp       , Gs^Fp       , Gs^Fp       , Gs^Fp       , Ww          , Gs^Fp       , Ww          , Ww          , Gs^Fms      , Ww          , Rp          , Gs^Fp       , Gs^Fp       , Ggf         , Gg^Ve       , Rp          , Rp          , Ww          , Ww          , Ggf         , Ggf         , Ggf         , Ggf         , Ggf         , Ggf         , Ggf         , Gs^Fp       , Ggf         , Ggf         , Cv          , Rp          , Cv          , Ggf         , Ggf         , Gs^Fp       , Ggf         , Gs^Fp       , Gs^Fp       , Rp          , Rp          
Gs^Fp       , Gs^Fp       , Gs^Fp       , Gs^Fp       , Ww          , Ww          , Gs^Fds      , Ww          , Gs^Fds      , Gs^Fms      , Rp          , Rp          , Ggf         , Ggf         , Ggf         , Ggf         , Gs^Fp       , Gs^Fp       , Rp          , Gs^Fp       , Gs^Fp       , Ww          , Ggf         , Gs^Fp       , Gs^Fp       , Gs^Fp       , Ggf         , Ggf         , Ggf         , Ggf         , Gs^Fp       , Gg^Fet      , Rp          , Ggf         , Gs^Fp       , Ggf         , Ggf         , Gs^Fp       , Rp          , Gs^Fp       , Rp          , Gs^Fp       
Gs^Fp       , Gs^Fp       , Ww          , Ww          , Gs^Fds      , Gs^Fds      , Gs^Fds      , Gs^Fds      , Rp          , Rp          , Gs^Fms      , Gs^Fms      , Gs^Fms      , Gs^Fp       , Ggf         , Gs^Fp       , Gs^Fp       , Rp          , Gs^Fp       , Gs^Fp       , Gs^Fp       , Ww          , Ww          , Ggf         , Gs^Fp       , Ggf         , Ggf         , Gs^Fp       , Gs^Fp       , Ggf         , Ggf         , Gs^Fp       , Rp          , Gs^Fp       , Ggf         , Ggf         , Rp          , Rp          , Gs^Fp       , Rp          , Gs^Fp       , Gs^Fp       
Ww          , Ww          , Ggf         , Gs^Fds      , Ggf         , Gg^Ve       , Gs^Fds      , Gs^Fds      , Rp          , Gs^Fms      , Gs^Fms      , Gs^Fms      , Gs^Fp       , Gg^Ve       , Ggf         , Ggf         , Ggf         , Rp          , Ggf         , Ggf         , Ggf         , Ggf         , Ggf         , Ww          , Gs^Fp       , Gs^Fp       , Gs^Fp       , Gs^Fp       , Gs^Fp       , Gs^Fp       , Gs^Fp       , Gs^Fp       , Gs^Fp       , Rp          , Rp          , Rp          , Ggf         , Ggf         , Gs^Fp       , Gs^Fp       , Gs^Fp       , Gs^Fp       
Gs^Fds      , Gs^Fds      , Gs^Fds      , Gs^Fds      , Gs^Fds      , Ggf         , Ggf         , Gs^Fds      , Rp          , Gs^Fms      , Gs^Fms      , Gs^Fp       , Gs^Fp       , Gs^Fp       , Gs^Fp       , Ggf         , Ggf         , Rp          , Rp          , Ggf         , Gs^Fp       , Gs^Fp       , Ww          , Ww          , Gs^Fp       , Gs^Fp       , Rp          , Gs^Fp       , Gs^Fp       , Gs^Fp       , Gs^Fp       , Gs^Fp       , Rp          , Rp          , Gs^Fp       , Ggf         , Gs^Fp       , Gs^Fp       , Gs^Fp       , Gs^Fp       , Gs^Fp       , Gs^Fp       
Gs^Fds      , Gs^Fds      , Rp          , Gs^Fds      , Gs^Fds      , Gs^Fds      , Ggf         , Gs^Fds      , Rp          , Rp          , Rp          , Gs^Fp       , Gs^Fp       , Gs^Fp       , Gs^Fp       , Gs^Fp       , Gs^Fp       , Ggf         , Rp          , Gs^Fp       , Gs^Fp       , Gs^Fp       , Gs^Fp       , Ww          , Rp          , Rp          , Gs^Fp       , Rp          , Rp          , Gs^Fp       , Rp          , Rp          , Gs^Fp       , Gs^Fp       , Gs^Fp       , Gs^Fp       , Gs^Fp       , Gs^Fp       , Gs^Fp       , Gs^Fp       , Gs^Fp       , Gs^Fp       
Rp          , Rp          , Gs^Fds      , Rp          , Rp          , Ggf         , Rp          , Rp          , Gs^Fms      , Gs^Fms      , Gs^Fms      , Rp          , Rp          , Gs^Fp       , Gs^Fp       , Gs^Fp       , Gs^Fp       , Gs^Fp       , Rp          , Gs^Fp       , Gs^Fp       , Gs^Fp       , Rp          , Ww^Bw/      , Ww          , Gs^Fp       , Ggf         , Gs^Fp       , Gs^Fp       , Rp          , Rp          , Gs^Fp       , Gs^Fp       , Gs^Fp       , Gs^Fp       , Gs^Fp       , Ggf         , Ggf         , Ggf         , Gg^Ve       , Gs^Fp       , Gs^Fp       
Gs^Fds      , Gs^Fds      , Gg^Ve       , Gs^Fds      , Gs^Fds      , Rp          , Gs^Fds      , Gs^Fds      , Gs^Fms      , Gs^Fp       , Gs^Fp       , Gs^Fp       , Rp          , Gs^Fp       , Gs^Fp       , Gg^Ve       , Gs^Fp       , Gs^Fp       , Gs^Fp       , Rp          , Rp          , Rp          , Gs^Fp       , Gs^Fp       , Ww          , Ggf         , Ggf         , Gs^Fp       , Gg^Ve       , Gs^Fp       , Gs^Fp       , Rp          , Rp          , Gs^Fp       , Gs^Fp       , Gs^Fp       , Ggf         , Ggf         , Ggf         , Ggf         , Gs^Fp       , Gs^Fp       
Gs^Fds      , Gs^Fds      , Gs^Fds      , Gs^Fds      , Rp          , Gs^Fds      , Rp          , Rp          , Rp          , Gs^Fms      , Gs^Fp       , Rp          , Gs^Fp       , Gs^Fp       , Gs^Fp       , Gs^Fp       , Gs^Fp       , Gs^Fp       , Rp          , Rp          , Gs^Fp       , Ggf         , Gs^Fp       , Gs^Fp       , Gs^Fp       , Ww          , Gs^Fp       , Ggf         , Gs^Fp       , Gs^Fp       , Rp          , Rp          , Gs^Fp       , Rp          , Rp          , Gs^Fp       , Gs^Fp       , Ggf         , Gs^Fp       , Gs^Fp       , Gs^Fp       , Gs^Fp       
Gs^Fds      , Gs^Fds      , Rp          , Rp          , Gs^Fds      , Rp          , Gs^Fp       , Gs^Fp       , Gs^Fp       , Rp          , Rp          , Rp          , Gs^Fp       , Gs^Fp       , Gs^Fp       , Gs^Fp       , Rp          , Rp          , Gs^Fp       , Ggf         , Ggf         , Ggf         , Ggf         , Ggf         , Gs^Fp       , Ww          , Gs^Fp       , Gs^Fp       , Gs^Fp       , Gs^Fp       , Rp          , Gs^Fp       , Gs^Fp       , Gs^Fp       , Gs^Fp       , Rp          , Rp          , Gs^Fp       , Gs^Fp       , Gs^Fp       , Rp          , Rp          
Gs^Fds      , Gs^Fds      , Rp          , Gs^Fms      , Gs^Fms      , Rp          , Rp          , Gs^Fp       , Ggf         , Gs^Fp       , Gs^Fp       , Rp          , Rp          , Gs^Fp       , Gs^Fp       , Gs^Fp       , Rp          , Gs^Fp       , Gs^Fp       , Gg^Ve       , Gg^Ve       , Ggf         , Ggf         , Gs^Fp       , Gs^Fp       , Ww          , Gs^Fp       , Gs^Fp       , Gs^Fp       , Gs^Fp       , Gs^Fp       , Rp          , Gs^Fp       , Gs^Fp       , Gs^Fp       , Gs^Fp       , Gs^Fp       , Rp          , Rp          , Rp          , Gs^Fp       , Gs^Fp       
Rp          , Rp          , Gs^Fms      , Gs^Fms      , Ggf         , Ggf         , Rp          , Gs^Fp       , Ggf         , Ggf         , Gg^Ve       , Gs^Fp       , Gs^Fp       , Rp          , Rp          , Rp          , Gs^Fp       , Gs^Fp       , Gs^Fp       , Gs^Fp       , Gs^Fp       , Gs^Fp       , Gs^Fp       , Gs^Fp       , Ww          , Ww          , Gs^Fp       , Gs^Fp       , Ggf         , Gs^Fp       , Ggf         , Rp          , Gs^Fp       , Gs^Fp       , Gs^Fp       , Ggf         , Gs^Fp       , Gs^Fp       , Gs^Fp       , Gs^Fp       , Gs^Fp       , Gs^Fp       
Gs^Fms      , Gs^Fms      , Gs^Fms      , Gs^Fms      , Ggf         , Ggf         , Gs^Fp       , Rp          , Rp          , Ggf         , Gs^Fp       , Gs^Fp       , Gs^Fp       , Gs^Fp       , Rp          , Gs^Fp       , Gs^Fp       , Gs^Fp       , Gs^Fp       , Gs^Fp       , Gs^Fp       , Gs^Fp       , Ww          , Ww          , Ggf         , Gs^Fp       , Gs^Fp       , Gs^Fp       , Gg^Ve       , Ggf         , Gs^Fp       , Rp          , Rp          , Gs^Fp       , Gs^Fp       , Gs^Fp       , Gs^Fp       , Gg^Ve       , Ggf         , Ggf         , Gs^Fp       , Gs^Fp       
Gs^Fp       , Gs^Fp       , Ggf         , Ggf         , Ggf         , Ggf         , Rp          , Rp          , Cv          , Cv          , Cv          , Ggf         , Ggf         , Gs^Fp       , Gs^Fp       , Rp          , Rp          , Gs^Fp       , Gs^Fp       , Gs^Fp       , Gs^Fp       , Gs^Fp       , Ww          , Gs^Fp       , Ggf         , Ggf         , Ggf         , Ggf         , Ggf         , Ggf         , Ggf         , Ggf         , Rp          , Rp          , Rp          , Gs^Fp       , Gs^Fp       , Gs^Fp       , Gs^Fp       , Ggf         , Gs^Fp       , Gs^Fp       
Gs^Fms      , Gs^Fms      , Ggf         , Ggf         , Gs^Fp       , Gs^Fp       , Rp          , Cv          , 3 Kv        , Cv          , Cv          , Ggf         , Ww          , Ww          , Ww          , Ww          , Ww^Bw|      , Ww          , Ww          , Wo          , Ww          , Gs^Fp       , Ww          , Gs^Fp       , Gg^Ve       , Ggf         , Ggf         , Ggf         , Ggf         , Gs^Fp       , Rp          , Rp          , Gs^Fp       , Gs^Fp       , Gs^Fp       , Rp          , Rp          , Gs^Fp       , Gs^Fp       , Gs^Fp       , Gs^Fp       , Gs^Fp       
Gs^Fms      , Gs^Fms      , Ggf         , Ggf         , Ggf         , Gs^Fp       , Rp          , Cv          , Cv          , Cv          , Ww          , Ww          , Ggf         , Gs^Fms      , Gs^Fms      , Ggf         , Rp          , Gs^Fms      , Gs^Fp       , Gs^Fms      , Gs^Fms      , Ww          , Ww          , Gs^Fp       , Gs^Fp       , Gs^Fp       , Gs^Fp       , Ggf         , Gs^Fp       , Gs^Fp       , Rp          , Gs^Fp       , Gs^Fp       , Gs^Fp       , Gs^Fp       , Gs^Fp       , Gs^Fp       , Rp          , Rp          , Gs^Fp       , Gs^Fp       , Gs^Fp       
Gs^Fms      , Gs^Fms      , Gs^Fds      , Ggf         , Ggf         , Ggf         , Gs^Fp       , Rp          , Ww^Bw\      , Ww          , Gs^Fp       , Gs^Fp       , Ggf         , Ggf         , Gs^Fms      , Gs^Fms      , Rp          , Gs^Fms      , Gs^Fms      , Gs^Fms      , Rp          , Gs^Fms      , Gs^Fms      , Ww          , Ww          , Ggf         , Ggf         , Gs^Fp       , Gs^Fp       , Rp          , Gs^Fp       , Ggf         , Ggf         , Gs^Fp       , Gs^Fp       , Gs^Fp       , Rp          , Gs^Fp       , Rp          , Gs^Fp       , Gs^Fp       , Gs^Fp       
Gs^Fms      , Gg^Ve       , Gs^Fds      , Gs^Fds      , Ggf         , Ggf         , Ww          , Ww          , Ggf         , Rp          , Ggf         , Ggf         , Ggf         , Gs^Fms      , Rp          , Rp          , Gg          , Rp          , Rp          , Rp          , Wo^Bw|      , Rp          , Rp          , Ggf         , Rp          , Ww          , Ggf         , Gs^Fp       , Gs^Fp       , Rp          , Gs^Fp       , Gs^Fp       , Ggf         , Ggf         , Gs^Fp       , Rp          , Ggf         , Rp          , Gs^Fp       , Rp          , Rp          , Rp          
Gs^Fms      , Gs^Fds      , Ww          , Gs^Fds      , Ww          , Ww          , Ggf         , Ggf         , Ggf         , Rp          , Ggf         , Ggf         , Gs^Fds      , Gs^Fms      , Rp          , Gs^Fms      , Gg          , Gg          , Wo          , Wo          , Wo^Bw/      , Wo          , Wo          , Rp          , Ggf         , Ww^Bw\      , Rp          , Gs^Fp       , Rp          , Rp          , Ggf         , Ggf         , Gs^Fp       , Gs^Fp       , Ggf         , Rp          , Ggf         , Gs^Fp       , Ggf         , Gs^Fp       , Gs^Fp       , Gs^Fp       
Ww          , Ww          , Ggf         , Ww          , Ggf         , Ggf         , Ggf         , Ggf         , Rp          , Rp          , Gs^Fms      , Gs^Fms      , Gs^Fms      , Rp          , Gs^Fms      , Gs^Fds      , Wo          , Wo          , Kv          , Wo^Bw/      , Wo^Bw|      , Wo^Bw\      , Kv          , Wo          , Wo          , Ww          , Rp          , Gs^Fp       , Rp          , Gs^Fp       , Gs^Fp       , Gs^Fp       , Ggf         , Gs^Fp       , Ggf         , Rp          , Ggf         , Ggf         , Gs^Fp       , Ggf         , Gs^Fp       , Gs^Fp       
Ggf         , Ggf         , Ggf         , Ggf         , Ggf         , Ggf         , Ggf         , Ggf         , Rp          , Gs^Fp       , Gs^Fms      , Gs^Fms      , Rp          , Rp          , Gs^Fds      , Wo^Bw\      , Cv          , Cv          , Wo          , Wo          , Wo^Bw|      , Wo          , Wo          , Cv          , Cv          , Wo^Bw/      , Wo          , Rp          , Gs^Fp       , Gs^Fp       , Gs^Fp       , Ggf         , Ggf         , Ggf         , Ggf         , Rp          , Ggf         , Gs^Fp       , Ggf         , Ggf         , Gs^Fp       , Gs^Fp       
Gs^Fms      , Gs^Fms      , Gs^Fms      , Ggf         , Gs^Fms      , Ggf         , Gs^Fp       , Gs^Fp       , Gs^Fms      , Rp          , Rp          , Rp          , Gs^Fms      , Gs^Fds      , Ggf         , Wo          , Cv          , Cv          , Cv          , Wo          , Wo^Bw|      , Wo          , Cv          , Cv          , Cv          , Wo          , Wo          , Ggf         , Gg^Ve       , Gs^Fp       , Gs^Fp       , Ggf         , Ggf         , Gs^Fp       , Ggf         , Rp          , Rp          , Rp          , Rp          , Ggf         , Ggf         , Ggf         
Gs^Fp       , Gs^Fms      , Gs^Fp       , Gs^Fms      , Ggf         , Ggf         , Gs^Fp       , Gs^Fms      , Rp          , Rp          , Gs^Fms      , Gs^Fds      , Gs^Fds      , Gs^Fds      , Gs^Fds      , Wo          , Kv          , Wo          , Wo          , Cv          , 2 Kv        , Cv          , Wo          , Wo          , Kv          , Wo          , Wo          , Gs^Fp       , Gs^Fp       , Gs^Fp       , Gs^Fp       , Gs^Fp       , Ggf         , Gs^Fp       , Ggf         , Gs^Fp       , Ggf         , Gs^Fp       , Gs^Fp       , Rp          , Rp          , Ggf         
Gs^Fp       , Gs^Fp       , Gs^Fp       , Ggf         , Gs^Fp       , Ggf         , Gs^Fp       , Rp          , Gs^Fms      , Rp          , Gs^Fms      , Gs^Fds      , Gs^Fds      , Gs^Fds      , Gs^Fds      , Wo          , Wo^Bw|      , Wo          , Wo^Bw/      , Wo^Bw/      , Cv          , Wo^Bw\      , Wo^Bw\      , Wo          , Wo^Bw|      , Wo          , Wo          , Gs^Fp       , Gs^Fp       , Ggf         , Ggf         , Gs^Fp       , Ggf         , Ggf         , Ggf         , Gs^Fp       , Ggf         , Ggf         , Ggf         , Ggf         , Gs^Fp       , Rp          
Gs^Fp       , Gs^Fp       , Gs^Fp       , Gs^Fp       , Gs^Fp       , Gs^Fp       , Rp          , Rp          , Gs^Fds      , Rp          , Rp          , Gs^Fds      , Gg^Ve       , Gs^Fds      , Gs^Fms      , Wo          , Wo^Bw|      , Wo^Bw/      , Wo          , Wo          , Cv          , Wo          , Wo          , Wo^Bw\      , Wo^Bw|      , Wo          , Wo          , Gs^Fp       , Ggf         , Ggf         , Ggf         , Gg^Ve       , Gs^Fp       , Gs^Fp       , Ggf         , Ggf         , Cv          , Ggf         , Ggf         , Gs^Fp       , Ggf         , Ggf         
Rp          , Gs^Fp       , Rp          , Gs^Fp       , Rp          , Rp          , Ggf         , Gs^Fms      , Gs^Fp       , Gs^Fms      , Rp          , Gs^Fds      , Gs^Fds      , Ggf         , Gs^Fds      , Wo^Bw/      , Wo          , Wo^Bw\      , Kv          , Wo          , Cv          , Wo          , Kv          , Wo^Bw/      , Wo          , Wo^Bw\      , Gs^Fp       , Gs^Fp       , Gs^Fp       , Gs^Fp       , Ggf         , Ggf         , Ggf         , Ggf         , Cv          , Ggf         , Cv          , Gg^Ve       , Cv          , Ggf         , Gs^Fp       , Ggf         
Gs^Fp       , Rp          , Ggf         , Rp          , Gs^Fp       , Rp          , Ggf         , Gs^Fms      , Gs^Fp       , Gs^Fms      , Gs^Fds      , Rp          , Rp          , Gs^Fms      , Gs^Fds      , Gs^Fms      , Gg^Ve       , Wo          , Wo          , Cv          , Cv          , Cv          , Wo          , Wo          , Gs^Fp       , Gs^Fp       , Gs^Fp       , Gs^Fp       , Gg^Ve       , Gs^Fp       , Gs^Fp       , Ggf         , Gs^Fp       , Ggf         , Ggf         , Cv          , 4 Kv        , Cv          , Ggf         , Ggf         , Ggf         , Ggf         
Gs^Fp       , Gs^Fp       , Gg^Ve       , Gs^Fp       , Ggf         , Rp          , Ggf         , Ggf         , Ggf         , Gg^Ve       , Gs^Fp       , Gs^Fms      , Gs^Fms      , Rp          , Rp          , Gs^Fds      , Gs^Fds      , Ww          , Ww          , Wo          , Wo          , Wo          , Gs^Fp       , Gs^Fp       , Gs^Fp       , Gg^Ve       , Gs^Fp       , Gs^Fp       , Ggf         , Ggf         , Gs^Fp       , Ggf         , Ggf         , Gs^Fp       , Cv          , Cv          , Cv          , Cv          , Cv          , Gs^Fp       , Ggf         , Ggf         
Gs^Fp       , Gs^Fp       , Gs^Fp       , Gs^Fp       , Gs^Fp       , Rp          , Gg^Ve       , Ggf         , Ggf         , Ggf         , Ggf         , Gs^Fms      , Gs^Fms      , Gs^Fds      , Rp          , Gs^Fms      , Gs^Fds      , Ww          , Gs^Fp       , Gs^Fp       , Gg^Ve       , Gs^Fp       , Gs^Fp       , Gs^Fp       , Ggf         , Gs^Fp       , Ggf         , Ggf         , Gs^Fp       , Gs^Fp       , Rp          , Ggf         , Ggf         , Gs^Fp       , Rp          , Rp          , Cv          , Ggf         , Ggf         , Ggf         , Gg^Ve       , Gs^Fp       
Gs^Fp       , Gs^Fp       , Gs^Fp       , Gs^Fp       , Gs^Fp       , Rp          , Gs^Fp       , Gs^Fp       , Ggf         , Ggf         , Ggf         , Ggf         , Gs^Fms      , Gs^Fms      , Gs^Fms      , Rp          , Ww^Bw\      , Ww          , Gs^Fp       , Gs^Fp       , Gs^Fp       , Gs^Fp       , Ggf         , Ggf         , Ggf         , Ggf         , Gs^Fp       , Gs^Fp       , Rp          , Rp          , Ggf         , Rp          , Rp          , Rp          , Gs^Fp       , Ggf         , Gs^Fp       , Gs^Fp       , Gs^Fp       , Gs^Fp       , Gs^Fp       , Gs^Fp       
Gs^Fp       , Gs^Fp       , Gs^Fp       , Gg^Ve       , Gs^Fp       , Rp          , Gs^Fp       , Gs^Fp       , Gs^Fp       , Ggf         , Ggf         , Gs^Fp       , Ww          , Ww          , Ww          , Ww          , Gs^Fp       , Rp          , Rp          , Gs^Fp       , Rp          , Ggf         , Rp          , Rp          , Rp          , Gs^Fp       , Rp          , Rp          , Gs^Fp       , Gs^Fp       , Gs^Fp       , Ggf         , Ggf         , Ggf         , Ggf         , Ggf         , Gs^Fp       , Gs^Fp       , Ggf         , Ggf         , Ggf         , Hh^Fp       
Gs^Fp       , Gs^Fp       , Gs^Fp       , Gs^Fp       , Gs^Fp       , Rp          , Gs^Fp       , Ggf         , Gs^Fp       , Gg^Ve       , Ggf         , Gs^Fp       , Ww          , Gs^Fp       , Gs^Fp       , Gs^Fp       , Gs^Fp       , Gg^Ve       , Gs^Fp       , Rp          , Gs^Fp       , Rp          , Gs^Fp       , Gs^Fp       , Gs^Fp       , Rp          , Gs^Fp       , Gs^Fp       , Gs^Fp       , Gs^Fp       , Gs^Fp       , Ggf         , Gs^Fp       , Ggf         , Ggf         , Ggf         , Gs^Fp       , Ggf         , Ggf         , Gg^Ve       , Ggf         , Ggf         
Gs^Fp       , Gs^Fp       , Gs^Fp       , Gs^Fp       , Gs^Fp       , Rp          , Gs^Fp       , Ggf         , Gs^Fp       , Ggf         , Ggf         , Gs^Fp       , Ww          , Gs^Fp       , Gs^Fp       , Gs^Fp       , Gs^Fp       , Gs^Fp       , Gs^Fp       , Rp          , Gs^Fp       , Gg          , Gs^Fp       , Gs^Fp       , Gs^Fp       , Gg          , Gs^Fp       , Gs^Fp       , Gs^Fp       , Gs^Fp       , Gs^Fp       , Ggf         , Ggf         , Ggf         , Ggf         , Ggf         , Ggf         , Ggf         , Ggf         , Ggf         , Ggf         , Ggf         
