border_size=1
usage=map

Xos^Ii      , Xos^Ii      , Gg^Fet      , Xos^Ii      , Gg^Fet      , Xos^Ii      , Gg^Fet      , Xos^Ii      , Xos^Ii      
Gg^Fet      , Rr^Ii       , Rr^Ii       , Rr^Ii       , Rr^Ii       , Rr^Ii       , Rr^Ii       , Rr^Ii       , Gg^Fet      
Xos^Ii      , Rr^Ii       , Rr^Ii       , Rr^Ii       , Cud         , Rr^Ii       , Rr^Ii       , Rr^Ii       , Xos^Ii      
Gg^Fet      , Rr^Ii       , Rr^Ii       , Kud^Ii      , Rr          , Kud^Ii      , Rr^Ii       , Rr^Ii       , Gg^Fet      
Xos^Ii      , Rr^Ii       , Rr^Ii       , Rr^Ii       , Rr^Ii       , Rr^Ii       , Rr^Ii       , Rr^Ii       , Xos^Ii      
Gg^Fet      , Rr^Ii       , Rr^Ii       , Rr^Ii       , Rr^Ii       , Rr^Ii       , Rr^Ii       , Rr^Ii       , Gg^Fet      
Xos^Ii      , Rr^Ii       , Rr^Ii       , Rr^Ii       , Rr^Ii       , Rr^Ii       , Rr^Ii       , Rr^Ii       , Xos^Ii      
Gg^Fet      , Rr^Ii       , Rr^Ii       , Rr^Ii       , Rr^Ii       , Rr^Ii       , Rr^Ii       , Rr^Ii       , Gg^Fet      
Xos^Ii      , Rr^Ii       , Rr^Ii       , Rr^Ii       , Rr^Ii       , Rr^Ii       , Rr^Ii       , Rr^Ii       , Xos^Ii      
Gg^Fet      , Rr^Ii       , Rr^Ii       , Rr^Ii       , 1 Rr^Ii     , Rr^Ii       , Rr^Ii       , Rr^Ii       , Gg^Fet      
Xos^Ii      , Rr^Ii       , Rr^Ii       , Rr^Ii       , Rr^Ii       , Rr^Ii       , Rr^Ii       , Rr^Ii       , Xos^Ii      
Gg^Fet      , Rr^Ii       , Rr^Ii       , Rr^Ii       , Rr^Ii       , Rr^Ii       , Rr^Ii       , Rr^Ii       , Gg^Fet      
Xos         , Rr^Ii       , Rr^Ii       , Rr^Ii       , Rr^Ii       , Rr^Ii       , Rr^Ii       , Rr^Ii       , Xos         
Gg^Fet      , Rr^Ii       , Rr^Ii       , Rr^Ii       , Rr^Ii       , Rr^Ii       , Rr^Ii       , Rr^Ii       , Gg^Fet      
